levelOneGrid = {
	"tileRows": 10,
	"tileColumns": 15,
	"tilePixelLength": 40,
	"tileBorderPixelWeight": 1,
	
	"mapArray": [
		[2, 2, 2, 2, 2, 2, 2, 2, 2, 2, 2, 2, 2, 2, 2],
		[1, 1, 1, 1, 1, 1, 1, 1, 1, 1, 1, 1, 1, 1, 1],
		[1, 2, 0, 0, 0, 0, 1, 1, 1, 1, 1, 1, 1, 1, 1],
		[1, 1, 0, 1, 1, 0, 1, 1, 1, 2, 1, 1, 2, 2, 2],
		[1, 1, 0, 1, 1, 0, 1, 1, 1, 0, 0, 0, 0, 0, 0],
		[0, 0, 0, 1, 1, 0, 1, 1, 1, 0, 1, 1, 2, 2, 2],
		[1, 1, 1, 1, 1, 0, 0, 0, 0, 0, 1, 1, 1, 1, 1],
		[1, 2, 1, 1, 1, 1, 1, 1, 1, 1, 1, 1, 1, 1, 1],
		[1, 1, 1, 1, 1, 1, 1, 1, 1, 1, 1, 1, 1, 1, 1],
		[2, 2, 2, 1, 1, 1, 2, 2, 2, 1, 1, 1, 2, 2, 1],
	],
	
	"startTile": { "row": 5, "column": 0 },
	"startDirection": "right",
	"destinationTile": { "row": 4, "column": 14 },
	
	"tileTurns": [ [5,2], [2,2], [2,5], [6,5], [6,9], [4,9] ]
}